111111111111111111111111111111111111111
1E0000000010000100X000000000000X00000X1
1000000000000001C1000000000000000C00001
1000000X0000000111000000X00000000000001
1000000C00000000000000X000000C00X0000C1
111111111111111111111111111111110000001
1P0011111111111111111111111111110000C01
100000000000000C00000C000000C0000000001
111111111111111111111111111111111111111