1111111111111111111111111111111111
1X000000X000000C00000C000000000E01
10100101001000000X0001000000X10101
1010010010101000000001000000010101
1P0000000C00C0X0000X00000X000000C1
1111111111111111111111111111111111