1111111111111111111111111111111111
100000000000X00C00000C000X00000E01
1010010100100000000001000000010101
1010010010101000000001000000010101
1P0000000C00C0000000000X00000000C1
1111111111111111111111111111111111